1111111111111
1P10100000101
101C101000001
1010101001001
101000101C011
1000101C11101
1110000011011
1000001110111
10000000E1111
1111111111111
