11111111111111111111111111111111111111111111111111111111111111111111111111111111111111111111111111111111111111111
1P000000000001000000000011100000000000000000000000000000000000000000000000000000000000000000000000000000000111111
11110111111110111111011111100000100000100111111001000000100000011111000000000000000000000000000000000000000111111
10000100000000100001000011100000100000100100000001000000100000010001000000000000000000000000000000000000000111111
10111101111110111101111011100000100000100100000001000000100000010001000000000000000000000000000000000000000111111
10000001000000010001000011100000111111100111111001000000100000010001000000000000000000000000000000000000000111111
11111101011110101111110111100000100000100100000001000000100000010001000000000000000000000000000000000000000111111
10000001000000010001000011100000100000100100000001000000100000010001000000000000000000000000000000000000000111111
10111111111110101111111011100000100000100111111001111110111111011111000000000000000000000000000000000000000111111
10000000000100000000000011100000000000000000000000000000000000000000000000001111000010000000000000000000000111111
11110111110111111110111011100000100000000010000000001011111100111110010000001000100010000000000000000000000111111
10000100000000000100001011100000010000000111000000010010000100100010010000001000010010000000000000000000000111111
10111101111110111101111011100000001000001000100000100010000100111110010000001000010010000000000000000000000111111
10000000000000100000000011100000000100010000010001000010000100110000010000001000010010000000000000000000000111111
11111110111110101111111111100000000010100000001010000010000100101000010000001000100000000000000000000000000111111
10000000100000010000000011100000000001000000000100000011111100100100011111101111000010000000000000000000000111111
10111111111110111111111011100000000000000000000000000000000000000000000000000000000000000000000000000000000111111
100000000000000000000C0011100000000000000000000000000000000000000000000000000000000000000000000000000000000111111
11111111111111111110111111100000000000000000000000010000000001000000000000000000000000000000000000000000000111111
10000000000000000000000011100000000000000000000000101000000010100000000000000000000000000000000000000000000111111
11111110111111111110111111100000000000000000000001000100000100010000000000000000000000000000000000000000000111111
10000000000000100000000011100000000000000000000010000010001000001000000000000000000000000000000000000000000111111
10111110111110111111111011100000000000000000000100000001010000000100000000000000000000000000000000000000000111111
10000000000000000000000011100000000000000000001000000000100000000010000000000000000000000000000000000000000111111
10000000000000000000000E11100000000000000000010000000000000000000001000000000000000000000000000000000000000111111
11111111111111111111111111100000000000000000100000000000000000000000100000000000000000000000000000000000000111111
11111111111111111111111111100000000000000000010000000000000000000001000000000000000000000000000000000000000111111
11111111111111111111111111100000000000000000001000000000000000000010000000000000000000000000000000000000000111111
11111111111111111111111111100000000000000000000100000000000000000100000000000000000000000000000000000000000111111
11111111111111111111111111100000000000000000000010000000000000001000000000000000000000000000000000000000000111111
11111111111111111111111111100000000000000000000001000000000000010000000000000000000000000000000000000000000111111
11111111111111111111111111100000000000000000000000100000000000100000000000000000000000000000000000000000000111111
11111111111111111111111111100000000000000000000000010000000001000000000000000000000000000000000000000000000111111
11111111111111111111111111100000000000000000000000001000000010000000000000010000000001000000001000000000000111111
11111111111111111111111111100000000000000000000000000100000100000000000000111000000001000000001000000000000111111
11111111111111111111111111100000000000000000000000000010001000000000000001000100000001000000001000000000000111111
11111111111111111111111111100000000000000000000000000001010000000000000010000010000001000000001000000000000111111
11111111111111111111111111100000000000000000000000000000100000000000000100000001000001111111111000000000000111111
11111111111111111111111111100000000000000000000000000000000000000000001111111111100001000000001000000000000111111
11111111111111111111111111100000000000000000000000000000000000000000010000000000010001000000001000000000000111111
11111111111111111111111111100000000000000000000000000000000000000000100000000000001001000000001000000000000111111
11111111111111111111111111100000000000000000000000000000000000000001000000000000000101000000001000000000000111111
11111111111111111111111111100000000000000000000000000000000000000000000000000000000000000000000000000000000111111
11111111111111111111111111111111111111111111111111111111111111111111111111111111111111111111111111111111111111111
11111111111111111111111111111111111111111111111111111111111111111111111111111111111111111111111111111111111111111
11111111111111111111111111111111111111111111111111111111111111111111111111111111111111111111111111111111111111111
11111111111111111111111111111111111111111111111111111111111111111111111111111111111111111111111111111111111111111
11111111111111111111111111111111111111111111111111111111111111111111111111111111111111111111111111111111111111111
11111111111111111111111111111111111111111111111111111111111111111111111111111111111111111111111111111111111111111
11111111111111111111111111111111111111111111111111111111111111111111111111111111111111111111111111111111111111111
11111111111111111111111111111111111111111111111111111111111111111111111111111111111111111111111111111111111111111
11111111111111111111111111111111111111111111111111111111111111111111111111111111111111111111111111111111111111111
11111111111111111111111111111111111111111111111111111111111111111111111111111111111111111111111111111111111111111
11111111111111111111111111111111111111111111111111111111111111111111111111111111111111111111111111111111111111111
11111111111111111111111111111111111111111111111111111111111111111111111111111111111111111111111111111111111111111
