1111111111111111111111111
1P00000000000100000000001
1111011111111011111101111
1000010000000010000100001
1011110111111011110111101
1000000100000001000100001
1111110101111010111111011
1000000100000001000100001
1011111111111010111111101
1000000000010000000000001
1111011111011111111011101
1000010000000000010000101
1011110111111011110111101
1000000000000010000000001
1111111011111010111111111
1000000010000001000000001
1011111111111011111111101
100000000000000000000C001
1111111111111111111011111
1000000000000000000000001
1111111011111111111011111
1000000000000010000000001
1011111011111011111111101
1000000000000000000000001
10000000000000000000000E1
1111111111111111111111111
