1111110
100C001
1P00001
100E111
1111111
