111111111111
1000C00110011
100000000011
10000P000011
1E1100000011
111111111111
