11111111
1000C111
11111111
1000P001
10000001
1E000001
11111111
