P111111
100C001
1E00001
1111111
