1111111111111111111111111111111111111111111111111111111111111111111111111111111111111111111111111111
1P00000000000000000000000000000000000000000000000001000000100000010000100000001000000001000000000011
10000000000000C0000000000000000000000000000000000001001000000100000010000010000000010000000000000011
1011111111111111111111111111111111111111111111111111111111111111111111111111111111111111111111111011
1010000000000000000000000000000000000000000000000000000C00000000000000000000000000000000000000000011
1010101011111111111101111111111100000111111111111111111111111111100100111111111111101111111111101011
101011111110000000100000000000011111111111111111111111111111111100000000000000000C000000000000010111
1010000000000111111111100000000000000000000000000000000000000000111111111111100000000111111111101011
101010111111000000000C11111111111111111111111111110000000001000000000000000011111111C000000000010111
1011000001000000000010000000000010000000000111000100000000100000100000100000000000000000001111010111
1000010100010000010000000001000000000C0000011100011101001000000000010000000000000000000000000C000111
1011111111111111111111111111111111111111111111111111111111111111111111111111111111111111111111111111
1010000000000000000000000000100000110100000100100010000000100000000000000000000000010101000000000111
10101111111C001000010001000000010010000001000000000000100000000000011001001001001000000000000001E111
1C00000000111111111111100000001000000111000000000000101010010011000000000000000000000000000000011111
1011111111111111111111111111111111111111111111111111111111111111111111111111111111111111111111111111
1111111111111111111111111111111111111111111111111111111111111111111111111111111111111111111111111111

