1111111
1C01C01
1001101
1P00101
10001C1
1000001
1E00001
1111111
