111111111
100000001
100P000C1
100C00001
10000E001
111111111
